R 1080 720
NO ./resources/textures/greystone.xpm
SO ./resources/textures/redbrick.xpm
EA ./resources/textures/wood.xpm
WE ./resources/textures/wood.xpm
S ./resources/textures/barrel.xpm
C 255,200,160
F 122,122,122

11111111111111111
10000000000000001
10200000200000201
1000S000000000001
10002000200020000
10000000000000001
10202020002020201
10000000000000001
10002000200200001
10000000000000001
10200000200002001
10000000000000001
11111111111111111
