R 1640 1150

NO ./resources/textures/redbrick.xpm
SO ./resources/textures/eagle.xpm
WE ./resources/textures/bluestone.xpm
EA ./resources/textures/mossy.xpm
S ./resources/textures/barrel.xpm
F 255,182,122
C 102,080,182

		1111111111111111111111111
		1000000000000000000000001
		1000000000000000000000001
	    1000000000000000000000001
111111111000000000000000000000001
100000000000000000000000000011111
100S0000000000000000000000001
10000000000000000000000000001
10000000000000000000000000001
10000200000000000000000000001
10000000000000000000000000001
10000001110000011100000000001
10000001 1000001 100000000001
11111111 1111111 111111111111
