R 1640 1480

NO ./resources/textures/redbrick.xpm
SO ./resources/textures/eagle.xpm
WE ./resources/textures/bluestone.xpm
EA ./resources/textures/mossy.xpm
S ./resources/textures/greenlight.xpm
F 255,182,122
C 102,080,182

		1111111111111111111111111
		1000000S00000000000000001
		1000000002000000200000001
	    1000000000000000000000001
111111111000000000000000000000001
100000000000111111100000000111111
1000000000001     10000000001
1000000000001     10000200001
1000000000001     10000000001
10000200000011111110000000001
10000000000000000000000000001
1000000111000001110000000000111
10000001 1000001 100000000001
11111111 1111111 111111111111
